1 2
10 10 10 10 10 10 40 43 44 10 10 10 10 10 10 10 10 10 10 10 10 10 10 10 10
20 20 20 20 20 20 30 32 33 20 20 20 20 20 20 20 20 20 20 20 20 20 20 20 20
22 22 22 22 22 22 31 32 34 22 22 22 22 22 22 22 22 22 22 22 22 22 22 22 22
10 10 90 10 10 90 40 43 44 90 10 10 10 10 90 10 10 10 90 90 90 10 10 10 10
10 90 10 10 10 10 40 43 44 10 90 90 10 90 90 90 10 10 90 10 10 10 10 10 10
42 42 42 42 42 42 41 43 45 46 46 46 46 46 46 46 46 46 46 46 46 46 46 46 46
50 50 50 50 50 50 50 50 50 50 50 50 50 50 50 50 50 50 50 50 50 50 50 50 50
10 10 10 10 10 10 10 10 10 10 10 10 90 90 10 10 10 10 90 90 90 10 10 10 10
90 10 10 10 90 10 10 10 10 10 90 10 10 10 90 10 10 10 10 10 10 10 10 10 10
10 10 10 10 10 10 10 10 10 10 10 10 10 10 10 10 10 10 10 10 10 10 10 10 10
10 10 10 10 10 10 10 10 10 10 10 10 10 10 10 10 10 10 10 10 10 10 10 10 10
10 10 10 10 10 10 10 90 10 10 90 10 10 10 10 10 10 10 10 10 10 90 10 10 10
10 10 10 10 10 10 10 10 10 10 10 10 10 10 10 10 10 10 10 10 10 10 10 10 10
10 10 10 10 10 10 10 10 10 10 10 10 10 10 10 10 10 10 10 10 10 10 10 10 10